0 0
19 20
..###################
....#.#.#.....#.....#
###.#.#.#.#####.###.#
#.#.....#.#...#.#...#
#.###.###.###.#.#####
#...#...#.#.........#
#.#.###.#.###.#######
#.#.........#.#...#.#
#.#.#.#######.###.#.#
#.#.#.........#.....#
#.###.#.###########.#
#.#.#.#.#.#.#...#...#
#.#.#.###.#.#.#####.#
#.#...#.....#.......#
#.#.#####.#.#.#######
#.#...#.#.#...#.....#
###.###.#.###.#####.#
#.#.......#.......#.#
#.#######.#.###.###.#
#.........#.#.......#
###################.#
